#############################################################
#-------------####------------------------------------------#
#------------##--##-----------------------------------------#
#-----------##----##----------------------------------------#
#----------##------##---------------------------------------#
#---------##--------##--------------------------------------#
#--------##----------##-------------------------------------#
#------###------------##------------------------------------#
#-----##---------------##-----------------------------------#
#----##-----------------##----------------------------------#
#---##------------------##----------------------------------#
#--##------------------##---------------##------------------#
####------------------##-------------#####------------------#
####-----------------##------------###---#------------------#
#--##---------------##--------######-----#------------------#
#---##-------------##---------#----------##-----------------#
#----##-----------###---------#-----------#-----------------#
#-----##----------------------#-----------#-----------------#
#-----##-----------###--------#-----------#-----------------#
#----##-------##--##-###------##----------##----------------#
#---##-------##--##-##-##------#-------#####----------------#
#--##-------##--##-##---##-----#----------------------------#
#---##-----##--##-##-----##-----------#########-------------#
#----##---##--##-##-------##----------#-------##------------#
#-----##-##--##-##---------##---------#--------#------------#
#------###---####-----------##--------#--------##-----------#
#-------#-----##-----------##---------#---------#-----------#
#------------##-----------##----------#---------#-----------#
#-----------##-----------##-----------#---------#-----------#
#-------------------------------------##--------#-----------#
#--------------------------------------#-------##-----------#
#------------##------------------------#-------#------------#
#-------------##-----##---------------------####------------#
#--------------##---##----------------------####------------#
#---------------##-##----------------------##--###----------#
#---------------####-----------######------##----##---------#
#----------------##-------######----#-----##------##--------#
#---------------------##------------#--------------####-----#
#--------------------##-------------#-----------------#-----#
#--------------------##-------------##----------------#-----#
#---------------------#--------------#---------------##-----#
#---------------------##-------------#--------------##------#
#----------------------#-------------##---------------------#
#----------------------#--------------#---------------------#
#----------------------#------------###---------------------#
#----------------------#---------####-----------------------#
#----------------------#--------##--------------------------#
#----------------------#---#--------------------------------#
#--------------------###---#--------------------------------#
#--------------------#-----##-------------------------------#
#--------------------#------#-------------------------------#
#--------------------#------#-------------------------------#
#--------------------##-----##------------------------------#
#---------------------#----###------------------------------#
#---------------------#-####--------------------------------#
#-----------------------------------------------------------#
#-----------------------------------------------------------#
#-----------------------------------------------------------#
#-----------------------------------------------------------#
#-----------------------------------------------------------#
#-----------------------------------------------------------#
#-----------------------------------------------------------#
#-----------------------------------------------------------#
#-----------------------------------------------------------#
#-----------------------------------------------------------#
#-----------------------------------------------------------#
#-----------------------------------------------------------#
#-----------------------------------------------------------#
#-----------------------------------------------------------#
#############################################################
